212
15
00000000000000000000000000000000000000000000000000000000000000000000000000000000000000000000000000000000000000000000000000000000000000000000000000000000000000000000000000000000000000000000000000000000000000000000
00000000000000000000000000000000000000000000000000000000000000000000000000000000000000000000000000000000000000000000000000000000000000000000000000000000000000000000000000000000000000000000000000000000000000000000
00000000000000000000000000000000000000000000000000000000000000000000000000000000000000000000000000000000000000000000000000000000000000000000000000000000000000000000000000000000000000000000000000000000000000000000
00000000000000000000000000000000000000000000000000000000000000000000000000000000000000000000000000000000000000000000000000000000000000000000000000000000000000000000000000000000000000000000000000000000000000000000
00000000000000000000000000000000000000000000000000000000000000000000000000000000000000000000000000000000000000000000000000000000000000000000000000000000000000000000000000000000000000000000000000000000000000000000
00000000000000000000004000000000000000000000000000000000000000000000000000000000222222220002224000000000000004000000000002220000244200000000000000000000000000000000000000000000000000000000330000000000000000000000
00000000000000000000000000000000000000000000000000000000000000000000000000000000000000000000000000000000000000000000000000000000000000000000000000000000000000000000000000000000000000000003330000000000000000000000
00000000000000000000000000000000000000000000000000000000000000000000000000000000000000000000000000000000000000000000000000000000000000000000000000000000000000000000000000000000000000000033330000000000000000000000
00000000000000000000000000000000000000000000000000000000000000000000000000000000000000000000000000000000000000000000000000000000000000000000000000000000000000000000000000000000000000000333330000000000000000000000
00000000000000004000242420000000000000000000005600000000056000000000000000000242000000000000002000002200004004004000002000000000022000000300300000000003300300000000000022420000000000003333330000000000000000000000
00000000000000000000000000000000000000560000007800000000078000000000000000000000000000000000000000000000000000000000000000000000000000003300330000000033300330000000000000000000000000033333330000000000000000000000
00000000000000000000000000005600000000780000007800000000078000000000000000000000000000000000000000000000000000000000000000000000000000033300333000000333300333000005600000000000000560333333330000000000000000000000
00000000000000000000000000007800000000780000007800000000078000000000000000000000000000000000000000000000000000000000000000000000000000333300333300003333300333300007800000000000000783333333330000000030000000000000
11111111111111111111111111111111111111111111111111111111111111111111100111111111111111111111111111111111111111111111111111111111111111111111111111111111100111111111111111111111111111111111111111111111111111111111
11111111111111111111111111111111111111111111111111111111111111111111100111111111111111111111111111111111111111111111111111111111111111111111111111111111100111111111111111111111111111111111111111111111111111111111